HTMLLANGUAGE=sv
BOOK=Boka tid
OPENHOURS=Öppettider
PRICES=Priser
EMPLOYEES=Personal
FINDUS=Hitta oss
PHONE=Telefon
MAIL=E-post
MONFRI=Mån - Fre
SATURDAY=Lördag
SUNDAY=Söndag
CLOSED=Stängt
HAIRCUT=Klippning
LIMITFORLONGHAIR=Gränsen för långt hår är 20 cm
LONGHAIR=Långt hår (60 min)
LONGHAIRREGULAR=Långt hår, stamkund
SHORTHAIR=Kort hår (30 min)
SHORTHAIRREGULAR=Kort hår, stamkund
BEARD=Skägg (20 min)
CHILD=Barn (0-13 år) (20 min)
OTHER=Annat
TRIMMING=Trimning (15 min)
COLORING=Färgning (90 min)
EXTENSIONSSHORT=Förlängningar, kort&nbsp;(45&nbsp;min)
EXTENSIONSNORMAL=Förlängningar, standard&nbsp;(45&nbsp;min)
EXTENSIONSLONG=Förlängningar, långt&nbsp;(45&nbsp;min)
MEETEMPLOYEES=Möt vår personal
FINDUS=Hitta oss
ADDRESS=Adress
HAIRSTYLIST=Hårstylist
BARBER=Barberare
COUNTRY=SVENSKA
COUNTRY=